first_name	last_name	city	state
Rebbecca	Didio	Leith	TA
Stevie	Hallo	Proston	QL
Mariko	Stayer	Hamel	WA
Gerardo	Woodka	Talmalmo	NS
Mayra	Bena	Lane Cove	NS
Idella	Scotland	Cartmeticup	WA
Sherill	Klar	Nyamup	WA
Ena	Desjardiws	Bendick Murrell	NS
Vince	Siena	Purrawunda	QL
Theron	Jarding	Blanchetown	SA
Amira	Chudej	Rockside	QL
Marica	Tarbor	Rosegarland	TA
Shawna	Albrough	Ringwood	QL
Paulina	Maker	Maylands	WA
Rose	Jebb	Wooloowin	QL
Reita	Tabar	Arthurville	NS
Maybelle	Bewley	Mapleton	QL
Camellia	Pylant	Tuggerawong	NS
Roy	Nybo	Red Hill	AC
Albert	Sonier	Inverlaw	QL
Hayley	Taghon	Eugowra	NS
Norah	Daleo	Kotara Fair	NS
Rosina	Sidhu	Burpengary	QL
Royal	Costeira	Ellis Beach	QL
Barrie	Nicley	Fish Creek	VI
Linsey	Gedman	Kennedy	QL
Laura	Bourbonnais	Cape Portland	TA
Fanny	Stoneking	Warra	QL
Kristian	Ellerbusch	Wanguri	NT
Gwen	Julye	Alvie	VI
Ben	Majorga	Wherrol Flat	NS
Trina	Oto	Placid Hills	QL
Emelda	Geffers	Nedlands	WA
Zana	Ploszaj	Auchenflower	QL
Shaun	Rael	Buninyong	VI
Oren	Lobosco	Dangar Island	NS
Catherin	Aguele	Sunny Nook	QL
Pearlene	Boudrie	Minden	QL
Kathryn	Bonalumi	Tibradden	WA
Suzan	Landa	Clermont	QL
Sommer	Agar	Kadina	SA
Keena	Rebich	Sawtell	NS
Rupert	Hinkson	East Gosford	NS
Aleta	Poarch	Fosterville	VI
Jamal	Korczynski	Bateau Bay	NS
Luz	Broccoli	Glenmoral	QL
Janessa	Ruthers	Bolivia	NS
Lavonne	Esco	East Melbourne	VI
Honey	Lymaster	Taringa	QL
Jean	Cecchinato	Koolan Island	WA
Katlyn	Flitcroft	Maleny	QL
Cassie	Soros	Yelverton	WA
Rolf	Gene	Flinders	NS
Darnell	Moothart	Empire Bay	NS
Cherilyn	Fraize	Rose Bay North	NS
Lynda	Lazzaro	Macks Creek	VI
Leigha	Capelli	East Toowoomba	QL
Delfina	Binnie	Bimbijy	WA
Carlota	Gephardt	Kundabung	NS
Alida	Helger	Pinnacle	QL
Donte	Resureccion	Watsonville	QL
Lou	Kriner	Seaforth	NS
Dortha	Vrieze	White Hills	TA
Genevive	Sanborn	Bellangry	NS
Alease	Strawbridge	Ascot	QL
Veda	Mishkin	Stafford Heights	QL
Craig	Vandersloot	Bygalorie	NS
Lauran	Tovmasyan	Boolaroo	NS
Aaron	Kloska	Brookhill	QL
Francene	Skursky	Hillston	NS
Zena	Daria	Ivanhoe East	VI
Brigette	Breckenstein	Caniambo	VI
Jeniffer	Jezek	Myrniong	VI
Selma	Elm	Woolamai	VI
Elenora	Handler	Wardering	WA
Nadine	Okojie	Kukerin	WA
Kristin	Shiflet	Somers	VI
Melinda	Fellhauer	Wayatinah	TA
Kirby	Litherland	Alligator Creek	QL
Kent	Ivans	Camp Mountain	QL
Dan	Platz	Brandy Creek	QL
Millie	Pirkl	Sovereign Hill	VI
Moira	Qadir	Arno Bay	SA
Reta	Qazi	Maffra	VI
Brittney	Lolley	Ulverstone	TA
Leandro	Bolka	Wattle Hill	TA
Edison	Sumera	Bower	SA
Breana	Cassi	Stonehaven	VI
Jarvis	Nicols	East Newdegate	WA
Felicitas	Orlinski	Emerald	VI
Geraldine	Neisius	Katunga	VI
Alfred	Pacleb	Willunga	SA
Leatha	Block	Two Rocks	WA
Jacquelyne	Rosso	Caldwell	NS
Jonelle	Epps	Coppabella	QL
Rosamond	Amlin	Calala	NS
Johnson	Mcenery	Nambucca Heads	NS
Elliot	Scatton	Mccullys Gap	NS
Gerri	Perra	Toowoomba South	QL
Rosendo	Jelsma	Applecross	WA
Eveline	Brickhouse	Camberwell West	VI
Laurene	Bennett	North Perth	WA
Tegan	Ebershoff	Coombell	NS
Tracie	Huro	Pacific Heights	QL
Mertie	Kazeck	Guildford	WA
Clare	Bortignon	Herron	WA
Rebeca	Baley	Mirrool	NS
Nilsa	Pawell	Bundaberg West	QL
Samuel	Arellanes	Lane Cove	NS
Ivette	Servantes	Reservoir	VI
Merrilee	Fajen	Upper Kedron	QL
Gianna	Eilers	Buchan	VI
Hyman	Phinazee	Beltana	SA
Buck	Pascucci	Kingswood	SA
Kenny	Leicht	Nicholls Rivulet	TA
Tabetha	Bai	Upper Mount Gravatt	QL
Alonso	Popper	Ridgley	TA
Alonzo	Polek	Tubbut	VI
Son	Magnotta	Collingullie	NS
Jesusita	Druck	Munno Para	SA
Annice	Kunich	Tyagarah	NS
Delila	Buchman	Redgate	WA
Iraida	Sionesini	Modewarre	VI
Alona	Driesenga	Stirling Range National Park	WA
Lajuana	Vonderahe	Trowutta	TA
Madelyn	Maestri	Rouse Hill	NS
Louann	Susmilch	Wyandra	QL
William	Devol	Goondi Hill	QL
Corazon	Grafenstein	Hill River	WA
Fairy	Burket	Fairview Park	SA
Lashawn	Urion	Bar Beach	NS
Ronald	Gayner	University Of Tasmania	TA
Shizue	Hayduk	Regent West	VI
Nida	Fitz	Oxley	QL
Amos	Limberg	Don	TA
Dexter	Prosienski	Nyora	VI
Ludivina	Calamarino	Croydon	QL
Ariel	Stavely	Scottsdale	TA
Haley	Vaughn	Montrose	VI
Raelene	Legeyt	Oak Park	VI
Micaela	Shiflett	Nailsworth	SA
Alpha	Prudhomme	Tarong	QL
Zack	Warman	Kensington Park	SA
Wilford	Pata	Ashmore	QL
Carman	Robasciotti	Granya	VI
Carylon	Bayot	Alexandra	VI
Gladys	Schmale	Wirrulla	SA
Matilda	Peleg	Weymouth	TA
Jacklyn	Wojnar	Summer Hill	NS
Tashia	Charney	Shailer Park	QL
Dorian	Eischens	Bell	NS
Jesus	Merkt	Licola	VI
Brandee	Svoboda	Walyormouring	WA
Edda	Mcquaide	Boronia	VI
Felix	Bumby	Baddaginnie	VI
Ben	Kellman	Berrilee	NS
Mickie	Upton	Barmaryee	QL
Phung	Krome	Longford	TA
Lashonda	Langanke	Simson	VI
Patria	Popa	Killabakh	NS
Nidia	Horr	Paluma	QL
Skye	Culcasi	Barnawartha	VI
Kanisha	Reyelts	Holwell	TA
Hector	Barras	Combienbar	VI
Stefan	Mongolo	Port Adelaide	SA
Francoise	Byon	Klemzig	SA
Lindy	Vandermeer	Emu Park	QL
Arthur	Diniz	Travancore	VI
Nicholle	Hulme	Whetstone	QL
Tijuana	Mesch	Corella	QL
Lorenza	Schoenleber	Humpty Doo	NT
Iola	Baird	Goode Beach	WA
Sang	Weigner	Heidelberg Rgh	VI
Leonor	Prez	Waterloo	NS
Silvana	Whelpley	Minyip	VI
Anthony	Stever	Hunchy	QL
Wenona	Carmel	Grosvenor Place	NS
Isadora	Yurick	Pacific Paradise	QL
Mose	Vonseggern	Hungerford	QL
Marci	Aveline	Boya	WA
Michel	Hoyne	Elizabeth West	SA
Stephania	Connon	Gumly Gumly	NS
Charolette	Turk	Wilmington	SA
Katie	Magro	Pagewood	NS
Inocencia	Angeron	Tawonga	VI
Nikita	Novosel	Hamlyn Heights	VI
Malcolm	Gohlke	Southtown	QL
Desiree	Englund	East Bowes	WA
Holley	Worland	Blue Haven	NS
Maryann	Tates	Cramphorne	WA
Ling	Dibello	Beelbi Creek	QL
Hailey	Kopet	Tanbar	QL
Farrah	Malboeuf	Ringwood	VI
Candra	Deritis	Battery Point	TA
Reuben	Hegland	Milton	NS
Anglea	Andrion	Laura	QL
Paris	Tuccio	Kidman Park	SA
Latricia	Schmoyer	Woodville	SA
Jeffrey	Leuenberger	Pedler Creek	SA
Dean	Vollstedt	Muckleford South	VI
Deane	Haag	Sydney South	NS
Edelmira	Pedregon	Bandy Creek	WA
Andrew	Keks	Carwarp	VI
Miesha	Decelles	Eltham	VI
Javier	Osmer	Doncaster East	VI
Kizzy	Stangle	Welbungin	WA
Sharan	Wodicka	Shenton Park	WA
Novella	Fritch	Girraween	NS
German	Dones	Woronora	NS
Robt	Blanck	Woodbury	TA
Rossana	Biler	Lee Point	NT
Henriette	Gish	Baranduda	VI
Buffy	Stitely	Police Point	TA
Christiane	Osmanski	Williamstown	WA
Annamae	Lothridge	Civic Square	AC
Vanesa	Glockner	Taragoola	QL
Gennie	Pastorino	Charleston	SA
Tamra	Kenfield	Kealy	WA
Tien	Kinney	Lillimur	VI
Malcom	Leja	Officer	VI
Claudia	Gawrych	Lilli Pilli	NS
Page	Entzi	Blue Rocks	TA
Lorita	Roches	Westminster	WA
Annita	Lek	Karama	NT
Eliseo	Mikovec	Ocean Shores	NS
Tyisha	Layland	Eastwood	SA
Colene	Tolbent	Gloucester	NS
Francis	Senters	Heidelberg Rgh	VI
Hester	Dollins	The Risk	NS
Susana	Baumgarter	Yanco	NS
Dahlia	Tummons	Port Fairy	VI
Osvaldo	Falvey	Queenton	QL
Armando	Barkley	Watercarrin	WA
Torie	Deras	Yeppoon	QL
Tamie	Hollimon	Bobalong	WA
Lettie	Hessenthaler	Wurdiboluc	VI
Chaya	Muhlbauer	North Dandalup	WA
Terina	Wildeboer	Seddon	VI
Lisbeth	Agney	Hindmarsh	WA
Lillian	Dominique	Julia Creek	QL
Corrina	Lindblom	Salter Point	WA
Dylan	Chaleun	Lilydale	QL
Jerrod	Luening	Tea Gardens	NS
Gracie	Vicente	Oxley	VI
Barabara	Amedro	Yallah	NS
Delsie	Ducos	Cavendish	VI
Cassie	Digregorio	Condobolin	NS
Tamekia	Kajder	West Tamworth	NS
Johanna	Saffer	Campsie	NS
Sharita	Kruk	Merrylands	NS
Gerald	Chrusciel	Townsville Milpo	QL
Ardella	Dieterich	Runnymede	QL
Jackie	Kellebrew	Coominya	QL
Mabelle	Ramero	Aroona	QL
Jonell	Biasi	Duramana	NS
Linwood	Wessner	Saltwater River	TA
Samira	Heninger	Bluff	QL
Julieta	Cropsey	Kingaroy	QL
Serita	Barthlow	Nangetty	WA
Tori	Tepley	Uarbry	NS
Nancey	Whal	Cudgera Creek	NS
Wilbert	Beckes	East Nanango	QL
Werner	Hermens	Oakleigh South	VI
Sunny	Catton	Gununa	QL
Keva	Moehring	Salamander Bay	NS
Mary	Dingler	Bundaberg North	QL
Huey	Bukovac	Middleton	SA
Antonio	Eighmy	Eaglemont	VI
Quinn	Weissbrodt	Premer	NS
Carin	Georgiades	Trott Park	SA
Jill	Davoren	Boynewood	QL
Sanjuana	Goodness	Maraylya	NS
Elin	Koerner	Wayville	SA
Charlena	Decamp	Burnside	WA
Annette	Breyer	Daradgee	QL
Alexis	Morguson	Weetulta	SA
Princess	Saffo	Auburn	NS
Ashton	Sutherburg	South Hobart	TA
Elmer	Redlon	Forbes	NS
Aliza	Akiyama	Forest Reefs	NS
Ora	Handrick	Rocklands	VI
Brent	Ahlborn	Oaklands Park	SA
Tora	Telch	Buckland Park	SA
Hildred	Eilbeck	Longwood	SA
Dante	Freiman	Varsity Lakes	QL
Emmanuel	Avera	Appin	NS
Keshia	Wasp	Adelaide River	NT
Sherman	Mahmud	Harris Park	NS
Lore	Brothers	Kallista	VI
Shawn	Weibe	Camena	TA
Karima	Cheever	Woodberry	NS
Francesco	Kloos	Rocky Gully	WA
King	Picton	Preston Beach	WA
Mica	Simco	Brigalow	QL
Lamonica	Princiotta	Beermullah	WA
Curtis	Ware	Ridgewood	WA
Sabrina	Rabena	Bayles	VI
Denae	Saeteun	Moorabbin Airport	VI
Anastacia	Carranzo	Waratah West	NS
Irving	Plocica	Cullulleraine	VI
Elenor	Siefken	Cairns City	QL
Mary	Irene	Warding East	WA
Crista	Padua	North Haven	NS
Lawana	Yuasa	Cape Paterson	VI
Maryrose	Cove	Cabramatta	NS
Lindsey	Rathmann	Kongorong	SA
Lynelle	Koury	Digby	VI
Brice	Bogacz	Sedan	SA
Laine	Killean	Braybrook	VI
Rachael	Crawley	Inkpen	WA
Della	Selestewa	Gillieston Heights	NS
Thomasena	Graziosi	Neerabup	WA
Frederic	Schimke	Mount Martha	VI
Halina	Dellen	Appila	SA
Ryann	Riston	Milton	QL
Shawn	Vugteveen	Etty Bay	QL
Leah	Milsap	Lower Hermitage	SA
Ira	Zihal	Degilbo	QL
Paris	Kinnison	Eastern Heights	QL
Shayne	Sundahl	Normanville	SA
Ernestine	Paavola	Yorkrakine	WA
Eleonore	Everline	Kialla East	VI
Misty	Leriche	Glen Boughton	QL
Na	Hodges	Ongerup	WA
Juan	Knudtson	Clunes	VI
Gerald	Kloepper	Pierces Creek	QL
Desmond	Tarkowski	Andergrove	QL
Tommy	Gennusa	Concord West	NS
Adrianna	Poncio	Bethania	QL
Adaline	Galagher	Barooga	NS
Tammi	Schiavi	Willetton	WA
Virgilio	Phay	Stratton	WA
Emeline	Sotelo	Elimbah	QL
Marcos	Seniff	Emerald	VI
Yuonne	Carabajal	Changerup	WA
Gladis	Kazemi	Varsity Lakes	QL
Muriel	Drozdowski	Durham Downs	QL
Juliann	Dammeyer	Bouvard	WA
Reiko	Dejarme	Bentley Dc	WA
Verdell	Garness	Thornton	NS
Arleen	Kane	Eagle Farm	QL
Launa	Vanauken	Peake	SA
Casandra	Gordis	Chippendale	NS
Julio	Puccini	Gorokan	NS
Alica	Alerte	Grevillia	NS
Karol	Sarkissian	Chatsworth	NS
Wava	Ochs	Bawley Point	NS
Felicitas	Gong	Weengallon	QL
Jamie	Kushnir	Tuggeranong Dc	AC
Fidelia	Dampier	Dangar Island	NS
Kris	Medich	Shannon	TA
Lashawna	Filan	Greenhills	WA
Lachelle	Andrzejewski	Cherrybrook	NS
Katy	Saltourides	Junee	NS
Bettyann	Fernades	Tibradden	WA
Valda	Levay	Tungkillo	SA
Lynette	Beaureguard	Tarawera	QL
Victor	Laroia	Scotts Head	NS
Pa	Badgero	Pakenham Upper	VI
Dorathy	Miskelly	Westerway	TA
Rodrigo	Schuh	Burrier	NS
Stanford	Waganer	East Nabawa	WA
Michael	Orehek	Millers Point	NS
Ines	Tokich	Bunya Mountains	QL
Dorinda	Markoff	Mayfield East	NS
Clarence	Gabbert	Verges Creek	NS
Omer	Radel	Hill River	WA
Winifred	Kingshott	Marshdale	NS
Theresia	Salomone	Bundall	QL
Daisy	Kearsey	Mount Nasura	WA
Aretha	Bodle	Parndana	SA
Bettina	Diciano	Dripstone	NS
Omega	Mangino	Gnotuk	VI
Dana	Vock	Yarralumla	AC
Naomi	Tuamoheloa	Muja	WA
Luis	Yerry	Summerhill	TA
Dominga	Barchacky	Port Flinders	SA
Isreal	Calizo	Wombeyan Caves	NS
Myrtie	Korba	Dartnall	WA
Jodi	Naifeh	Dural	NS
Pearly	Hedstrom	Wandering	WA
Aileen	Menez	Manjimup	WA
Glory	Carlo	Grange	QL
Kathrine	Francoise	Indented Head	VI
Domingo	Mckale	Marla	SA
Julian	Laprade	Mungabunda	QL
Marylou	Lofts	Houston	VI
Louis	Brueck	Larrakeyah	NT
Ellsworth	Guenther	Docklands	VI
Wilburn	Lary	Gabbadah	WA
Arlie	Borra	Morundah	NS
Alysa	Lehoux	Trungley Hall	NS
Marilynn	Herrera	Tawonga	VI
Scot	Jarva	Kingswood	NS
Adelaide	Ender	Greenslopes	QL
Jackie	Borchelt	Grovedale	VI
Carli	Bame	Elanora	QL
Coletta	Thro	North Fremantle	WA
Katheryn	Lamers	Fyshwick	AC
Santos	Wisenbaker	Allworth	NS
Kimberely	Weyman	Kingsway West	NS
Earlean	Suffern	Woodford	NS
Dannette	Heimbaugh	Breakaway	QL
Odelia	Hutchin	Gorrie	WA
Lina	Schwiebert	Koorlong	VI
Fredric	Johanningmeie	Wardell	NS
Alfreda	Delsoin	Bongeen	QL
Bernadine	Elamin	Waverley	NS
Ming	Thaxton	Forrest	VI
Gracia	Pecot	Gundaroo	NS
Yuette	Metevelis	North Boyanup	WA
Yuriko	Kazarian	Mouroubra	WA
Hyman	Hegeman	Flinders University	SA
Linette	Summerfield	Crows Nest	QL
Jospeh	Couzens	Panmure	VI
Anna	Ovit	Bygalorie	NS
Shawnta	Woodhams	Oakhurst	NS
Ettie	Luckenbach	Mandurah East	WA
Chara	Leveston	Daisy Hill	VI
Lauran	Huntsberger	Willetton	WA
Pansy	Todesco	Tarnagulla	VI
Georgeanna	Silverstone	Steels Creek	VI
Jesus	Liversedge	Broken Head	NS
Jamey	Tetter	Bundaberg West	QL
Alberta	Motter	Port Melbourne	VI
Ronald	Grube	Happy Valley	SA
Tamala	Hickie	Benambra	VI
Gerry	Mohrmann	Brockman	WA
Isaiah	Kueter	Amphitheatre	VI
Magnolia	Overbough	Penrith	NS
Ngoc	Guglielmina	Darke Peak	SA
Julene	Lauretta	Mole Creek	TA
Magda	Lindbeck	Emerald Beach	NS
Shantell	Lizama	Logan Village	QL
Audria	Piccinich	Coober Pedy	SA
Nickole	Derenzis	Berowra Heights	NS
Grover	Reynolds	Innaloo	WA
Rocco	Bergstrom	Leeman	WA
Ethan	Quintero	East Damboring	WA
Glynda	Sanzenbacher	Kinglake West	VI
Yolande	Scrimsher	Canning Vale	WA
Twanna	Sieber	Upper Glastonbury	QL
Rosenda	Petteway	Caroline Springs	VI
Lacey	Francis	Hunchy	QL
Cordie	Meikle	Hamlyn Terrace	NS
Annalee	Graleski	Darbys Falls	NS
Dana	Ladeau	Pinnacle	QL
Wai	Raddle	Carlsruhe	VI
Johana	Conquest	Paulls Valley	WA
Tomas	Fults	Mirani	QL
Karon	Etzler	Buckland	TA
Delbert	Houben	Mitta Mitta	VI
Ashleigh	Rimmer	Boat Harbour Beach	TA
Nenita	Mckenna	Botany	NS
Micah	Shear	Scaddan	WA
Stefany	Figueras	Lenswood	SA
Rene	Burnsworth	Farrell Flat	SA
Cary	Orazine	Melrose	SA
Micheal	Ocken	Freemans Waterhole	NS
Frederick	Tamburello	Simpsons Bay	TA
Burma	Noa	Ripponlea	VI
Cherry	Roh	North Cascade	WA
Gabriele	Frabotta	Ensay	VI
Clement	Chee	Golden Point	VI
Beckie	Apodace	Middle Cove	NS
Catrice	Fowlkes	Waterfront Place	QL
Richelle	Remillard	Buraminya	WA
Cherri	Miccio	Balnagowan	QL
Dorethea	Taketa	Lower Cressbrook	QL
Barb	Latina	Larrakeyah	NT
Bettye	Meray	Middleton	TA
Sherrell	Sprowl	Oak Flats	NS
Ruth	Niglio	Orange Hill	QL
Alva	Shoulders	Welshpool	WA
Carri	Palaspas	Minnenooka	WA
Onita	Milbrandt	Wagga Wagga South	NS
Jessenia	Sarp	Wansbrough	WA
Tricia	Peressini	Pintharuka	WA
Stephaine	Manin	Eumundi	QL
Florinda	Gudgel	Halton	NS
Marsha	Farnham	Glenmore Park	NS
Josefa	Oakland	Mccutcheon	QL
Deeann	Nicklous	Pimpimbudgee	QL
Jeannetta	Vonstaden	Ilford	NS
Desmond	Amuso	Caparra	NS
Trina	Bakey	Duaringa	QL
Ramonita	Picotte	Weston	NS
Temeka	Bodine	Clunes	NS
Bea	Iida	Oakey	QL
Soledad	Mockus	Barton	AC
Margurite	Okon	Lanena	TA
Artie	Saine	Cora Lynn	VI
Major	Studwell	Allora	QL
Veronika	Buchauer	Willow Tree	NS
Christene	Cisney	Keilor Downs	VI
Miles	Feldner	Barringun	QL
Julio	Mikel	Pilliga	NS
Aide	Ghera	Rhodes	NS
Noelia	Brackett	Castletown	WA
Lenora	Delacruz	Turill	NS
